.............
.............
.............
.....BBB.....
..S.B...B.S..
.SSS..B..SSS.
..S...B..HSH.
WWHWWWHHWHHHH
.............
.............
......B......
.....BXB.....
.....BBB.....
