.............
.S.S.....S.S.
..S.......S..
.S.SS...SS.S.
.....S.S.....
..S.......S..
.S....X....S.
..S.S.B.S.S..
.....B.B.....
.S....B....S.
..S.......S..
.S.SS...SS.S.
.....S.S.....