.............
..SHS........
...H.HS......
.H....HB.....
.HH..H.HS....
.H.H.H..HB...
.H..H...HHS..
..H....HHHHB.
...H..H.HHHH.
B.....H..HHHS
BB.....H.HHHH
SBB...B.H.HHH
SSBB.BXBH..HH