.............
.HHH.....HHH.
.H.B.....B.H.
...B.S.S.B...
.HH..B.B..HH.
.H.B.B.B.B.H.
.....WWW.....
.H.B.B.B.B.H.
.HH..B.B..HH.
...B.S.S.B...
.H.B.....B.H.
.HHH.X.B.HHH.
.....BBB.....