..B..B.B.B...
HBBB.B.S.BB..
HHH..B.B.B.BB
HWWWWWWWWWW.W
.B....BB.....
..B..BBBBBBSS
BB.B.BBBHBSSB
...S.S.HHHH..
WW.WWWWW.WWWW
HH.B..BB.....
HHB.B..B.SBB.
HSB.B.B..B.B.
.....BXB.B.B.