...W....W....
WW.W.WWWW.WWW
HHB..B..W.WHW
HWWWW.S..BHHH
HH.W..W.WWWWH
WW.W.WW..W...
..BHB.BH.W..W
.WWHWWWW.HB.W
B..B..W.HHW.W
WW.WW.WBWWW..
..B.HH..HW..W
.WWWH.B..W.WW
.W...BXB.....